NO ./textures/tile357.xpm
SO ./textures/tile357.xpm

WE ./textures/tile357.xpm
EA ./textures/tile356.xpm


F 100,100,100
C 0,170,219

        1111111111111111        
    1   11111 1 1011111111111111111111    111111
    1111100011 110001100000000011111111   110001
    100000101010111100000000001            111111
    111110000000000000000000001111111
1111111110110000011100000000000001
1000000000010011111101111010111111
11110011110111001100000010001 
  1101111001111110001001000111 
111001   10001000000000010001
10000111100000000000000000001111111
10000000000000001100N000111000001
11000001110101000000000011 111111
  110111 11101011100000001111
   11111 1111111 111111111111 
                        111